                              
                              
                              
                              
                              
        #######               
        #######               
        #######               
        ###############       
        #######       #       
        #######       #       
        #######       #       
           #          #       
           #          #       
           #      #######     
          ######  #######     
          ######  #######     
          ######  #######     
          ######     ##       
          ######     ##       
          ######     ##       
          ######     ##       
           #         ##       
           #         ##       
           #         ##       
           #        ####      
           #        ####      
           #        ####      
         ###############      
         # #        ####      
         ########## ####      
      ############# ####      
      #############  #        
      ################        
      #############           
      #########               
                              
                              
                              
                              